C 10,30,0
F      100,100,0

NO ./textures/wall1.xpm
SO ./textures/wall2.xpm
EA ./textures/wall3.xpm
WE ./textures/wall4.xpm

1111111111111111111111111
1000000000110000000000001
1000000001010000000000001
10000E0000000000000000001
1111111110110000011100001
100000000011000001110111111111111
11110111111111011100000010001
11110111111111011101010010001
1100000011011101110000000001
100000000001 1001100000010001
10000000000111001101010010001
1100000111010101111101111000111
11110111 1110101 101111010001
11111111 1111111 111111111111
